$META;
tileset = cave;
camlock = 30.00 -30.00 32.00 -24.00;
--
Sign;
    -1.00 0.00;
    Can you reach all the checkpoints? :);
--
Plat;
    -20.5 3.0 2.5;
    0 0 0 0 2;
--
Rect;
    -13.0 -19.5 10.0 4.5;
    2 2 2 2 2 2 2 2 2 2 2 2 2 2 2 2 2 2 2 3
    4 0 0 0 0 0 0 0 0 0 0 0 0 0 0 0 0 0 0 5
    4 0 0 0 0 0 0 0 0 0 0 0 0 0 0 0 0 0 0 5
    4 0 0 0 0 0 0 0 0 0 0 0 0 0 0 0 0 0 0 5
    4 0 0 0 0 0 0 0 0 0 0 0 0 0 0 0 0 0 0 5
    4 0 0 0 0 0 0 0 0 0 0 0 0 0 0 0 0 0 0 5
    4 0 0 0 0 0 0 0 0 0 0 0 0 0 0 0 0 0 0 5
    4 0 0 0 0 0 0 0 0 0 0 0 0 0 0 0 0 0 0 5
    6 7 7 7 7 7 7 7 7 7 7 7 7 7 7 7 7 7 7 8;
--
Plat;
    19.0 0.0 3.0;
    1 0 0 0 0 0;
--
Rect;
    12.5 -19.5 9.5 4.5;
    1 2 2 2 2 2 2 2 2 4 4 2 2 2 2 2 2 2 2
    4 0 0 0 0 0 0 0 0 0 0 0 0 0 0 0 0 0 5
    4 0 0 0 0 0 0 0 0 0 0 0 0 0 0 0 0 0 5
    4 0 0 0 0 0 0 0 0 0 0 0 0 0 0 0 0 0 5
    4 0 0 0 0 0 0 0 0 0 0 0 0 0 0 0 0 0 5
    4 0 0 0 0 0 0 0 0 0 0 0 0 0 0 0 0 0 5
    4 0 0 0 0 0 0 0 0 0 0 0 0 0 0 0 0 0 5
    4 0 0 0 0 0 0 0 0 0 0 0 0 0 0 0 0 0 5
    6 7 7 7 7 7 7 7 7 7 7 7 7 7 7 7 7 7 8;
--
Rect;
    -31.5 -14.5 1.5 2.5;
    1 2 0
    4 0 5
    4 0 5
    4 0 5
    6 7 8;
--
Rect;
    6.0 12.5 16.0 1.5;
    2 2 2 2 2 2 2 2 2 2 2 2 2 2 2 2 2 2 2 2 2 2 2 2 2 2 2 2 2 2 2 2
    4 0 0 0 0 0 0 0 0 0 0 0 0 0 0 0 0 0 0 0 0 0 0 0 0 0 0 0 0 0 0 5
    6 7 7 7 7 7 7 7 7 7 7 7 7 7 7 7 7 7 7 7 7 7 7 7 7 7 7 7 7 7 7 8;
--
Rect;
    -26.5 -19.5 3.5 4.5;
    1 2 2 2 2 2 2
    4 0 0 0 0 0 5
    4 0 0 0 0 0 5
    4 0 0 0 0 0 5
    4 0 0 0 0 0 5
    4 0 0 0 0 0 5
    4 0 0 0 0 0 5
    4 0 0 0 0 0 5
    6 7 7 7 7 7 8;
--
Rect;
    -0.5 27.5 22.5 3.5;
    2 2 2 2 2 2 2 2 2 2 2 2 2 2 2 2 2 2 2 2 2 2 2 2 2 2 2 2 2 2 2 2 2 2 2 2 2 2 2 2 2 2 2 2 2
    4 0 0 0 0 0 0 0 0 0 0 0 0 0 0 0 0 0 0 0 0 0 0 0 0 0 0 0 0 0 0 0 0 0 0 0 0 0 0 0 0 0 0 0 5
    4 0 0 0 0 0 0 0 0 0 0 0 0 0 0 0 0 0 0 0 0 0 0 0 0 0 0 0 0 0 0 0 0 0 0 0 0 0 0 0 0 0 0 0 5
    4 0 0 0 0 0 0 0 0 0 0 0 0 0 0 0 0 0 0 0 0 0 0 0 0 0 0 0 0 0 0 0 0 0 0 0 0 0 0 0 0 0 0 0 5
    4 0 0 0 0 0 0 0 0 0 0 0 0 0 0 0 0 0 0 0 0 0 0 0 0 0 0 0 0 0 0 0 0 0 0 0 0 0 0 0 0 0 0 0 5
    4 0 0 0 0 0 0 0 0 0 0 0 0 0 0 0 0 0 0 0 0 0 0 0 0 0 0 0 0 0 0 0 0 0 0 0 0 0 0 0 0 0 0 0 5
    6 7 7 7 7 7 7 7 7 7 7 7 7 7 7 7 7 7 7 7 7 7 7 7 7 7 7 7 7 7 7 7 7 7 7 7 7 7 7 7 7 7 7 7 8;
--
Plat;
    -1.0 0.0 3.0;
    1 0 0 0 0 2;
--
Plat;
    19.5 19.0 2.5;
    1 0 0 0 0;
--
Tri;
    -14.0 11.0 3.0 0.5;
    16 17 2
    16 17 14 0 5
    16 17 14 0 0 0 5;
--
Rect;
    -13.5 -9.0 2.5 4.0;
    0 0 0 0 0
    4 0 0 0 5
    4 0 0 0 5
    4 0 0 0 5
    4 0 0 0 5
    4 0 0 0 5
    4 0 0 0 5
    0 7 7 7 8;
--
Rect;
    -8.5 -7.5 2.5 5.5;
    2 2 2 2 3
    4 0 0 0 5
    4 0 0 0 5
    4 0 0 0 5
    4 0 0 0 5
    4 0 0 0 5
    4 0 0 0 5
    4 0 0 0 5
    4 0 0 0 5
    4 0 0 0 5
    6 7 7 7 8;
--
Rect;
    13.0 -12.0 1.0 3.0;
    1 3
    4 5
    4 5
    4 5
    4 5
    6 8;
--
Rect;
    -26.5 9.0 3.5 22.0;
    1 2 2 2 2 2 2
    4 0 0 0 0 0 5
    4 0 0 0 0 0 5
    4 0 0 0 0 0 5
    4 0 0 0 0 0 5
    4 0 0 0 0 0 5
    4 0 0 0 0 0 5
    4 0 0 0 0 0 5
    4 0 0 0 0 0 5
    4 0 0 0 0 0 5
    4 0 0 0 0 0 5
    4 0 0 0 0 0 5
    4 0 0 0 0 0 5
    4 0 0 0 0 0 5
    4 0 0 0 0 0 5
    4 0 0 0 0 0 5
    4 0 0 0 0 0 5
    4 0 0 0 0 0 5
    4 0 0 0 0 0 5
    4 0 0 0 0 0 5
    4 0 0 0 0 0 5
    4 0 0 0 0 0 5
    4 0 0 0 0 0 5
    4 0 0 0 0 0 5
    4 0 0 0 0 0 5
    4 0 0 0 0 0 5
    4 0 0 0 0 0 5
    4 0 0 0 0 0 5
    4 0 0 0 0 0 5
    4 0 0 0 0 0 5
    4 0 0 0 0 0 5
    4 0 0 0 0 0 5
    4 0 0 0 0 0 5
    4 0 0 0 0 0 5
    4 0 0 0 0 0 5
    4 0 0 0 0 0 5
    4 0 0 0 0 0 5
    4 0 0 0 0 0 5
    4 0 0 0 0 0 5
    4 0 0 0 0 0 5
    4 0 0 0 0 0 5
    4 0 0 0 0 0 5
    4 0 0 0 0 0 5
    6 7 7 7 7 7 8;
--
Rect;
    27.0 -12.0 5.0 12.0;
    2 2 2 2 2 2 2 2 2 3
    4 0 0 0 0 0 0 0 0 5
    4 0 0 0 0 0 0 0 0 5
    4 0 0 0 0 0 0 0 0 5
    4 0 0 0 0 0 0 0 0 5
    4 0 0 0 0 0 0 0 0 5
    4 0 0 0 0 0 0 0 0 5
    4 0 0 0 0 0 0 0 0 5
    4 0 0 0 0 0 0 0 0 5
    4 0 0 0 0 0 0 0 0 5
    4 0 0 0 0 0 0 0 0 5
    4 0 0 0 0 0 0 0 0 5
    4 0 0 0 0 0 0 0 0 5
    4 0 0 0 0 0 0 0 0 5
    4 0 0 0 0 0 0 0 0 5
    4 0 0 0 0 0 0 0 0 5
    4 0 0 0 0 0 0 0 0 5
    4 0 0 0 0 0 0 0 0 5
    4 0 0 0 0 0 0 0 0 5
    4 0 0 0 0 0 0 0 0 5
    4 0 0 0 0 0 0 0 0 5
    4 0 0 0 0 0 0 0 0 5
    4 0 0 0 0 0 0 0 0 5
    6 7 7 7 7 7 7 7 7 8;
--
Tri;
    -15.0 -5.0 3.0 0.5;
    16 17 2
    16 17 14 0 5
    16 17 14 0 0 0 5;
--
Rect;
    33.0 1.5 1.0 2.5;
    0 3
    4 5
    4 5
    4 5
    6 8;
--
Rect;
    -17.5 -9.5 1.5 4.5;
    1 14 0
    4 0 5
    4 0 5
    4 0 5
    4 0 5
    4 0 5
    4 0 5
    4 0 5
    6 7 8;
--
Rect;
    27.0 17.0 5.0 14.0;
    2 2 2 2 2 2 2 2 2 3
    4 0 0 0 0 0 0 0 0 5
    4 0 0 0 0 0 0 0 0 5
    4 0 0 0 0 0 0 0 0 5
    4 0 0 0 0 0 0 0 0 5
    4 0 0 0 0 0 0 0 0 5
    4 0 0 0 0 0 0 0 0 5
    4 0 0 0 0 0 0 0 0 5
    4 0 0 0 0 0 0 0 0 5
    4 0 0 0 0 0 0 0 0 5
    4 0 0 0 0 0 0 0 0 5
    4 0 0 0 0 0 0 0 0 5
    4 0 0 0 0 0 0 0 0 5
    4 0 0 0 0 0 0 0 0 5
    4 0 0 0 0 0 0 0 0 5
    4 0 0 0 0 0 0 0 0 5
    4 0 0 0 0 0 0 0 0 5
    4 0 0 0 0 0 0 0 0 5
    4 0 0 0 0 0 0 0 0 5
    4 0 0 0 0 0 0 0 0 5
    4 0 0 0 0 0 0 0 0 5
    4 0 0 0 0 0 0 0 0 5
    4 0 0 0 0 0 0 0 0 5
    4 0 0 0 0 0 0 0 0 5
    4 0 0 0 0 0 0 0 0 5
    4 0 0 0 0 0 0 0 0 5
    4 0 0 0 0 0 0 0 0 5
    6 7 7 7 7 7 7 7 7 8;
--
Checkpoint;
    -21.0 3.75;
--
Checkpoint;
    18.0 -14.25;
--
Checkpoint;
    20.0 19.75;
--
Checkpoint;
    31.0 0.75;
--
Checkpoint;
    -29.0 -14.25;
--
Blast;
    1.0 -25.5 31.0 1.5;
--
Blast;
    -37.0 -25.5 7.0 1.5;
--
Blast;
    37.0 -15.5 5.0 11.5;
--
